NO ./textures-stylemineraft/north.xpm
SO ./textures-stylemineraft/south.xpm
WE ./textures-stylemineraft/west.xpm
EA ./textures-stylemineraft/east.xpm





F 220,100,0
C 225,30,0



11111111111111111111111111111111111111111111111111111111111111111111111111111111
10001000000000000000000000000000000000000000000000000000000000000000000000000001
10N01000000000000000000000000000000000000000000000000000000000000000000000000001
10001000000000000000000000000000000000000000000000000000000000000000000000000001
11111111111111111111111111111111111111111111111111111111111111111111111111111111