NO ./textures-stylemineraft/north.xpm
SO ./textures-stylemineraft/south.xpm
WE ./textures-stylemineraft/west.xpm
F 220,100,0
EA ./textures-stylemineraft/east.xpm


C 225,30,0

        1111111111111111111111111
        1000000000110000111000001
        1011000001110000000000001
        1001000000000000111000001
111111111011000001110000000000001
100000000011000001110111111111111
111101111111110111000000100011111
111101111111110111010100100000001
11000000110101011100000010001111111
1000000000000000110000001S001    01
10000000000000001101010010011111111
110000011101010111110111100111
11110111 1110101 101111010001
11111111 1111111 11111111111