NO ./textures-stylemineraft/north.xpm
SO ./textures-stylemineraft/south.xpm
WE ./textures-stylemineraft/west.xpm
EA ./textures-stylemineraft/east.xpm





F 220,100,0
C 225,30,0



11111111111111111111111111111111111111111111111111111111111111111111111111111111
10001000000000000000000000000000000000000000000000000000000000000000000000000001
10N010000000000000000000S0000000000000N00000000000000000000000000000000000000001
10001000000000000000000000000000000000000000000000000000000000000000000000000001
11111111111111111111111111111111111111111111111111111111111111111111111111111111