NO ./textures/north.xpm
SO ./textures/south.xpm
WE ./textures/west.xpm
EA ./textures/east.xpm
F 50,50,50
C 135,206,235

11111111111111111111111111111111111111111111111111
10000000000000000000000000000000000000000000000001
10111111111111111111111111111111111111111111111101
10100000000000000000000000000000000000000000000101
10101111111111111111111111111111110000000000000101
10101000000000000000000000000000010111111111110101
10101011111111111111111111111110010000000000010101
10101010000000000000000000000010011111111110010101
10101010111111111111111111110010000000000010010101
10101010100000000000000000010011111111110010010101
10101010101111111111111110010000000000010010010101
10101010101000000000000010011111111110010010010101
10101010101011111111110010000000000010010010010101
10101010101010000000010011111111010010010010010101
10101010101010111110010000000001010010010010010101
10101010101010100010011111111101010010010010010101
10101010101010101010000000000001010010010010010101
10101010101010101011111111111101010010010010010101
10101010101010101000000000000001010010010010010101
10101010101010101111111111111101010010010010010101
10101010101010100000000000000001010010010010010101
10101010101010111111111111111101010010010N10010101
10101010101010000000000000000001010010010010010101
10101010101011111111111111111101010010010010010101
10101010101000000000000000000001010010010010010101
10101010101111111111111111111101010010010010010101
10101010100000000000000000000001010010010010010101
10101010111111111111111111111111010010010010010101
10101010000000000000000000000000010010010010010101
10101011111111111111111111111111110010010010010101
10101000000000000000000000000000000010010010010101
10101111111111111111111111111111111110010010010101
10100000000000000000000000000000000000010010010101
10111111111111111111111111111111111111110010010101
10000000000000000000000000000000000000000010010101
11111111111111111111111111111111111111111110010101
10000000000000000000000000000000000000000000010101
10111111111111111111111111111111111111111111110101
10100000000000000000000000000000000000000000000101
10101111111111111111111111111111111111111111111101
10101000000000000000000000000000000000000000000001
10101011111111111111111111111111111111111111111111
10101010000000000000000000000000000000000000000001
10101010111111111111111111111111111111111111111101
10101010100000000000000000000000000000000000000101
10101010101111111111111111111111111111111111110101
10101010101000000000000000000000000000000000010101
10101010101011111111111111111111111111111111010101
10000000000000000000000000000000000000000000000001
11111111111111111111111111111111111111111111111111
