NO ./textures-minos/north.xpm
SO ./textures-minos/south.xpm
WE ./textures-minos/west.xpm
EA ./textures-minos/east.xpm

F 100,60,30
C 5,5,10

111111111111111111111111111111111111111111111111111111111
100101010101010101010101010101010101010101010101010101011
100000000000000000000000000000000000000000000000000000011
110000000000000000000000000000000000000000000000000000001
100011111111111111111111111111111111111111111111111110011
110010000000000000000000000000000000000000000000000010001
100010111111111111111111111111111111111111111111111010011
110010100000000000000000000000000000000000000000001010001
100010101111111111111111111111111111111111111111101010011
110010101000000000000000000000000000000000000000101010001
100010101011111111111111111111111111111111111110101010011
110010101010000000000000000000000000000000000010101010001
100010101010111111111111111111111111111111111010101010011
110010101010100000000000000000000000000000001010101010001
100010101010101111111111111111111111111111101010101010011
110010101010101000000000000000000000000000101010101010001
100010101010101011111111111111111111111110101010101010011
110010101010101010000000000000000000000010101010101010001
100010101010101010111111111111111111111010101010101010011
110010101010101010100000000000000000001010101010101010001
100010101010101010101111111111111111101010101010101010011
110010101010101010101000000000000000101010101010101010001
100010101010101010101011111111111110101010101010101010011
110010101010101010101010000000000010101010101010101010001
100010101010101010101010111111111010101010101010101010011
110010101010101010101010100000001010101010101010101010001
100010101010101010101010101000001010101010101010101010011
11001010101010101010101010100N001010101010101010101010001
100010101010101010101010101000001010101010101010101010011
110010101010101010101010101110111010101010101010101010001
100010101010101010101010101000001010101010101010101010011
110010101010101010101010101111111010101010101010101010001
100010101010101010101010100000000010101010101010101010011
110010101010101010101010101111111110101010101010101010001
100010101010101010101010100000000000101010101010101010011
110010101010101010101010101111111111101010101010101010001
100010101010101010101010100000000000001010101010101010011
110010101010101010101010101111111111111010101010101010001
100010101010101010101010100000000000000010101010101010011
110010101010101010101010101111111111111110101010101010001
100010101010101010101010100000000000000000101010101010011
110010101010101010101010101111111111111111101010101010001
100010101010101010101010100000000000000000001010101010011
110010101010101010101010101111111111111111111010101010001
100010101010101010101010100000000000000000000010101010011
110010101010101010101010101111111111111111111110101010001
100010101010101010101010100000000000000000000000101010011
110010101010101010101010101111111111111111111111101010001
100010101010101010101010100000000000000000000000001010011
110010101010101010101010101111111111111111111111111010001
100010100000000000000000000000000000000000000000000010011
110010111111111111111111111111111111111111111111111110001
100010000000000000000000000000000000000000000000000000011
110000000000000000000000000000000000000000000000000000001
101010101010101010101010101010101010101010101010101010101
111111111111111111111111111111111111111111111111111111111
