NO ./textures/north.xpm
SO ./textures-fullrobin/south.xpm
WE ./textures/west.xpm
EA ./textures/east.xpm

F 220,100,100



C 225,130,0



11111111111111111111111111111111111111111111111111111111111111111111111111111111
10001000000000000000000000000000000000000000000000000000000000000000000000000001
1000100S00000000000000000000000000000000000000000000000000000000000000000000001
10001000000000000000000000000000000000000000000000000000000000000000000000000001
11111111111111111111111111111111111111111111111111111111111111111111111111111111
