NO ./tex/north.xpm
SO ./tex/south.xpm
WE ./tex/west.xpm
EA ./tex/east.xpm
F 150,150,150
C 200,200,255

1111111111
1000000001
1011111101
10N0000001
1011111101
1000000001
1111111111
